1111111111111
1001000000PC1
1000011111001
100011E1C0001
1111111111111