1111111111111
1CC1CCCCCCCC1
1CCCC11111CC1
1PEC111111CC1
1111111111111