1111111111111111111111111111111111
1000000000000C00000000000000000001
1010010101100C00101001000000010101
101001000C101010001101000000010101
1P00000000010000001000000000000001
1000000000000C00000000000000000001
1000000000000C00000000000000000001
1000000000000C00000000000E00000001
1000000000000C00000000000000000001
1000000000000C00000000000000000001
1111111111111111111111111111111111