1111111111111111111
111111P011100111111
1C00110C10000C00111
1000C0000000000C011
100000001100000C001
1C0000C0010000CEC01
1000C1100110000C011
1110000000001C00111
1111111111111C11111
1111111111111111111