1111111111111
10010E00010C1
1000011111001
1P00110EC1001
1111111111111